{
    "map_name":   "rachmaninoff bound",
    "map_author": "leaf (original)",
    "map_notes":  "",
    "difficulty": 5,
    "map_width":  128,
    "map_height": 20,
    "init_lives": 300,
    "start_pos":  [96,160],
    "tile_dat":   [[0,0,0,0,0,0,0,0,0,0,0,0,0,0,0,0,0,0,0,0,0,0,0,0,0,0,0,0,0,0,0,0,0,0,0,0,0,0,0,0,0,0,0,0,0,0,0,0,0,0,0,0,0,0,0,0,0,0,0,0,0,0,0,0,0,0,0,0,0,0,0,0,0,0,0,0,0,0,0,0,0,0,0,0,0,0,0,0,0,0,0,0,0,0,0,0,0,0,0,0,0,0,0,0,0,0,0,0,0,0,0,0,0,0,0,0,0,0,0,0,0,0,0,0,0,0,0,0],
                   [0,0,0,0,0,0,0,0,0,0,0,0,0,0,0,0,0,0,0,0,0,0,0,0,0,0,0,0,0,0,0,0,0,0,0,0,0,0,0,0,0,0,0,0,0,0,0,0,0,0,0,0,0,0,0,0,0,0,0,0,0,0,0,0,0,0,0,0,0,0,0,0,0,0,0,0,0,0,0,0,0,0,0,0,0,0,0,0,0,0,0,0,0,0,0,0,0,0,0,0,0,0,0,0,0,0,0,0,0,0,0,0,0,0,0,0,0,0,0,0,0,0,0,0,0,0,0,0],
                   [0,0,0,0,0,0,0,0,0,0,0,0,0,0,0,0,0,0,0,0,0,0,0,0,0,0,0,0,0,0,0,0,0,0,0,0,0,0,0,0,0,0,0,0,0,0,0,0,0,0,0,0,0,0,0,0,0,0,0,0,0,0,0,0,0,0,0,0,0,0,0,0,0,0,0,0,0,0,0,0,0,0,0,0,0,0,0,0,0,0,0,0,0,0,0,0,0,0,0,0,0,0,0,0,0,0,0,0,0,0,0,0,0,0,0,0,0,0,0,0,0,0,0,0,0,0,0,0],
                   [0,0,0,1,1,1,1,1,1,1,1,1,1,0,0,0,0,0,0,0,0,0,0,0,0,0,0,0,0,0,0,0,0,0,0,0,0,0,0,0,0,1,1,1,1,1,1,1,1,1,1,0,0,0,0,0,0,0,0,0,0,0,0,0,0,0,0,0,0,0,0,0,0,0,0,1,1,1,1,1,1,1,1,1,1,0,0,0,0,0,0,0,0,0,0,0,0,0,0,0,0,0,0,0,0,0,0,0,0,0,0,0,0,0,0,0,0,0,0,0,0,0,0,0,0,0,0,0],
                   [0,0,0,1,5,5,5,5,2,2,2,2,1,0,0,0,0,0,0,0,0,0,0,0,0,0,0,0,0,0,0,0,0,0,0,0,0,0,0,0,0,1,5,5,5,5,2,2,2,2,1,0,0,0,0,0,0,0,0,0,0,0,0,0,0,0,0,0,0,0,0,0,0,0,0,1,5,5,5,5,2,2,2,2,1,0,0,0,0,0,0,0,0,0,0,0,0,0,0,0,0,0,0,0,0,0,0,0,0,0,0,0,0,0,0,0,0,0,0,0,0,0,0,0,0,0,0,0],
                   [0,0,0,1,5,5,5,5,2,2,2,2,1,0,0,0,0,0,0,0,0,0,0,0,0,0,0,0,0,0,0,1,1,1,1,1,1,1,1,1,1,1,5,5,5,5,2,2,2,2,1,1,1,1,1,1,1,1,1,1,1,0,0,0,0,0,0,1,1,1,1,1,1,0,0,1,5,5,5,5,2,2,2,2,1,0,0,0,0,1,1,1,1,1,1,0,0,0,0,0,0,0,0,0,0,0,0,0,0,0,0,0,0,0,0,0,0,0,0,0,0,0,0,0,0,0,0,0],
                   [0,0,0,1,5,5,5,5,2,2,2,2,1,0,0,0,0,0,0,0,0,0,0,0,0,0,0,0,0,0,0,1,5,5,5,5,2,2,2,2,4,4,5,5,5,5,2,2,2,2,4,4,5,5,5,5,2,2,2,2,1,0,0,0,0,0,0,1,2,2,2,2,1,0,0,1,5,5,5,5,2,2,2,2,1,0,0,0,0,1,2,2,2,2,1,0,0,0,0,0,0,0,0,0,0,0,0,0,0,0,0,0,0,0,0,0,0,0,0,0,0,0,0,0,0,0,0,0],
                   [0,0,0,1,5,5,5,5,2,2,2,2,1,1,1,1,1,1,1,1,1,1,1,0,0,0,0,0,0,0,0,1,5,5,5,5,2,2,2,2,4,4,5,5,5,5,2,2,2,2,4,4,5,5,5,5,2,2,2,2,1,0,0,0,0,0,0,1,2,2,2,2,1,0,0,1,5,5,5,5,2,2,2,2,1,1,1,1,1,1,2,2,2,2,1,1,1,1,1,0,0,1,1,1,1,1,1,0,0,0,0,0,0,0,0,0,0,0,0,0,0,0,0,0,0,0,0,0],
                   [0,0,0,1,5,5,5,5,2,2,2,2,4,4,5,5,5,5,2,2,2,2,1,0,0,0,0,0,0,0,0,1,5,5,5,5,2,2,2,2,4,4,5,5,5,5,2,2,2,2,4,4,5,5,5,5,2,2,2,2,1,0,0,0,0,0,0,1,2,2,2,2,1,0,0,1,5,5,5,5,2,2,2,2,4,4,5,5,5,5,2,2,2,2,5,5,5,5,1,0,0,1,5,5,5,5,1,0,0,0,0,0,0,0,0,0,0,0,0,0,0,0,0,0,0,0,0,0],
                   [0,0,0,1,5,5,5,5,2,2,2,2,4,4,5,5,5,5,2,2,2,2,1,0,0,0,0,0,0,1,1,1,5,5,5,5,2,2,2,2,4,4,5,5,5,5,2,2,2,2,4,4,5,5,5,5,2,2,2,2,1,1,1,1,1,1,1,1,2,2,2,2,1,1,1,1,5,5,5,5,2,2,2,2,4,4,5,5,5,5,2,2,2,2,5,5,5,5,1,1,1,1,5,5,5,5,1,1,1,1,1,1,1,1,1,1,1,0,0,0,0,0,0,0,0,0,0,0],
                   [0,0,0,1,5,5,5,5,2,2,2,2,4,4,5,5,5,5,2,2,2,2,1,0,0,0,0,0,0,1,2,2,2,2,1,1,1,1,1,1,1,1,5,5,5,5,2,2,2,2,1,1,1,1,2,2,2,2,5,5,5,5,2,2,2,2,5,5,5,5,2,2,2,2,4,4,5,5,5,5,2,2,2,2,4,4,5,5,5,5,1,1,1,1,5,5,5,5,2,2,2,2,5,5,5,5,2,2,2,2,5,5,5,5,4,4,1,0,0,0,0,0,0,0,0,0,0,0],
                   [0,0,0,1,5,5,5,5,2,2,2,2,4,4,5,5,5,5,2,2,2,2,1,1,1,1,1,1,1,1,2,2,2,2,1,0,0,0,0,0,0,1,5,5,5,5,2,2,2,2,1,0,0,1,2,2,2,2,5,5,5,5,2,2,2,2,5,5,5,5,2,2,2,2,4,4,5,5,5,5,2,2,2,2,4,4,5,5,5,5,1,0,0,1,5,5,5,5,2,2,2,2,5,5,5,5,2,2,2,2,5,5,5,5,4,4,1,0,0,0,0,0,0,0,0,0,0,0],
                   [0,0,0,1,5,5,5,5,2,2,2,2,1,1,1,1,1,1,5,5,5,5,2,2,2,2,5,5,5,5,2,2,2,2,1,0,0,0,0,0,0,1,5,5,5,5,2,2,2,2,1,0,0,1,2,2,2,2,5,5,5,5,2,2,2,2,5,5,5,5,2,2,2,2,4,4,5,5,5,5,2,2,2,2,1,1,1,1,1,1,1,0,0,1,2,2,2,2,2,2,2,2,1,1,1,1,2,2,2,2,5,5,5,5,4,4,1,0,0,0,0,0,0,0,0,0,0,0],
                   [0,0,0,1,5,5,5,5,2,2,2,2,1,0,0,0,0,1,5,5,5,5,2,2,2,2,5,5,5,5,2,2,2,2,1,0,0,0,0,0,0,1,5,5,5,5,2,2,2,2,1,0,0,1,2,2,2,2,5,5,5,5,2,2,2,2,5,5,5,5,2,2,2,2,4,4,5,5,5,5,2,2,2,2,1,0,0,0,0,0,0,0,0,1,2,2,2,2,2,2,2,2,1,0,0,1,2,2,2,2,5,5,5,5,4,4,1,0,0,0,0,0,0,0,0,0,0,0],
                   [0,0,0,1,5,5,5,5,2,2,2,2,1,0,0,0,0,1,5,5,5,5,2,2,2,2,5,5,5,5,1,1,1,1,1,0,0,0,0,0,0,1,5,5,5,5,2,2,2,2,1,0,0,1,1,1,1,1,1,1,1,1,1,1,1,1,1,1,1,1,1,1,1,1,1,1,5,5,5,5,2,2,2,2,1,0,0,0,0,0,0,0,0,1,2,2,2,2,1,1,1,1,1,0,0,1,1,1,1,1,1,1,1,1,1,1,1,0,0,0,0,0,0,0,0,0,0,0],
                   [0,0,0,1,5,5,5,5,2,2,2,2,1,0,0,0,0,1,5,5,5,5,2,2,2,2,5,5,5,5,1,0,0,0,0,0,0,0,0,0,0,1,5,5,5,5,2,2,2,2,1,0,0,0,0,0,0,0,0,0,0,0,0,0,0,0,0,0,0,0,0,0,0,0,0,1,5,5,5,5,2,2,2,2,1,0,0,0,0,0,0,0,0,1,2,2,2,2,1,0,0,0,0,0,0,0,0,0,0,0,0,0,0,0,0,0,0,0,0,0,0,0,0,0,0,0,0,0],
                   [0,0,0,1,1,1,1,1,1,1,1,1,1,0,0,0,0,1,1,1,1,1,1,1,1,1,1,1,1,1,1,0,0,0,0,0,0,0,0,0,0,1,1,1,1,1,1,1,1,1,1,0,0,0,0,0,0,0,0,0,0,0,0,0,0,0,0,0,0,0,0,0,0,0,0,1,1,1,1,1,1,1,1,1,1,0,0,0,0,0,0,0,0,1,1,1,1,1,1,0,0,0,0,0,0,0,0,0,0,0,0,0,0,0,0,0,0,0,0,0,0,0,0,0,0,0,0,0],
                   [0,0,0,0,0,0,0,0,0,0,0,0,0,0,0,0,0,0,0,0,0,0,0,0,0,0,0,0,0,0,0,0,0,0,0,0,0,0,0,0,0,0,0,0,0,0,0,0,0,0,0,0,0,0,0,0,0,0,0,0,0,0,0,0,0,0,0,0,0,0,0,0,0,0,0,0,0,0,0,0,0,0,0,0,0,0,0,0,0,0,0,0,0,0,0,0,0,0,0,0,0,0,0,0,0,0,0,0,0,0,0,0,0,0,0,0,0,0,0,0,0,0,0,0,0,0,0,0],
                   [0,0,0,0,0,0,0,0,0,0,0,0,0,0,0,0,0,0,0,0,0,0,0,0,0,0,0,0,0,0,0,0,0,0,0,0,0,0,0,0,0,0,0,0,0,0,0,0,0,0,0,0,0,0,0,0,0,0,0,0,0,0,0,0,0,0,0,0,0,0,0,0,0,0,0,0,0,0,0,0,0,0,0,0,0,0,0,0,0,0,0,0,0,0,0,0,0,0,0,0,0,0,0,0,0,0,0,0,0,0,0,0,0,0,0,0,0,0,0,0,0,0,0,0,0,0,0,0],
                   [0,0,0,0,0,0,0,0,0,0,0,0,0,0,0,0,0,0,0,0,0,0,0,0,0,0,0,0,0,0,0,0,0,0,0,0,0,0,0,0,0,0,0,0,0,0,0,0,0,0,0,0,0,0,0,0,0,0,0,0,0,0,0,0,0,0,0,0,0,0,0,0,0,0,0,0,0,0,0,0,0,0,0,0,0,0,0,0,0,0,0,0,0,0,0,0,0,0,0,0,0,0,0,0,0,0,0,0,0,0,0,0,0,0,0,0,0,0,0,0,0,0,0,0,0,0,0,0]],
    "obstacle_1": {
        "startbox": [128,64,192,256],
        "endbox":   [672,64,736,256],
        "revive":   [160,160],
        "actions":  [["move_player", 0], ["add_lives", 0], ["change_music", ""]],
        "loc_1":    [224,128,288,192],
        "loc_2":    [288,128,352,192],
        "loc_3":    [288,192,352,256],
        "loc_4":    [352,192,416,256],
        "loc_5":    [416,192,480,256],
        "loc_6":    [480,160,544,224],
        "loc_7":    [512,96,576,160],
        "loc_8":    [576,96,640,160],
        "exp_1":    [["2","3","5","7","8"], ["overlord","overlord","overlord","overlord","overlord"], 7],
        "exp_2":    [["2","3","5","6","8"], ["overlord","overlord","overlord","overlord","overlord"], 7],
        "exp_3":    [["1","3","4","6","8"], ["overlord","overlord","overlord","overlord","overlord"], 7],
        "exp_4":    [["1","3","4","6","8"], ["overlord","overlord","overlord","overlord","overlord"], 7],
        "exp_5":    [["1","2","4","6","7"], ["overlord","overlord","overlord","overlord","overlord"], 7],
        "exp_6":    [["1","2","4","5","7"], ["overlord","overlord","overlord","overlord","overlord"], 7]
    },
    "obstacle_2": {
        "startbox": [736,64,800,256],
        "endbox":   [1216,64,1280,256],
        "revive":   [768,128],
        "actions":  [["move_player", 0], ["add_lives", 0], ["change_music", ""]],
        "loc_1":    [832,96,896,160],
        "loc_2":    [896,96,960,160],
        "loc_3":    [864,160,928,224],
        "loc_4":    [928,160,992,224],
        "loc_5":    [992,160,1056,224],
        "loc_6":    [1056,160,1120,224],
        "loc_7":    [1088,96,1152,160],
        "loc_8":    [1120,160,1184,224],
        "loc_9":    [992,160,1024,192],
        "loc_10":   [1024,160,1056,192],
        "loc_11":   [992,192,1024,224],
        "loc_12":   [1024,192,1056,224],
        "exp_1":    [["2","3","4","6","8","11","12"], ["overlord","overlord","overlord","overlord","overlord","scourge","scourge"], 8],
        "exp_2":    [["2","3","4","7","9","10","12"], ["overlord","overlord","overlord","overlord","scourge","scourge","scourge"], 8],
        "exp_3":    [["1","2","4","6","7","9","10","11"], ["overlord","overlord","overlord","overlord","overlord","scourge","scourge","scourge"], 8],
        "exp_4":    [["1","3","4","6","8","11","12"], ["overlord","overlord","overlord","overlord","overlord","scourge","scourge"], 8],
        "exp_5":    [["1","2","3","5","7"], ["overlord","overlord","overlord","overlord","overlord"], 8],
        "exp_6":    [["1","2","3","5","7","8"], ["overlord","overlord","overlord","overlord","overlord","overlord"], 8]
    },
    "obstacle_3": {
        "startbox": [1280,64,1344,256],
        "endbox":   [1856,64,1920,256],
        "revive":   [1312,160],
        "actions":  [["move_player", 0], ["add_lives", 0], ["change_music", ""]],
        "loc_1":    [1376,128,1440,192],
        "loc_2":    [1440,96,1504,160],
        "loc_3":    [1504,128,1568,192],
        "loc_4":    [1504,192,1568,256],
        "loc_5":    [1568,160,1632,224],
        "loc_6":    [1632,128,1696,192],
        "loc_7":    [1696,160,1760,224],
        "loc_8":    [1760,160,1824,224],
        "exp_1":    [["2","4","5","7"], ["overlord","overlord","overlord","overlord"], 8],
        "exp_2":    [["2","3","5","7","8"], ["overlord","overlord","overlord","overlord","overlord"], 8],
        "exp_3":    [["1","3","4","6","8"], ["overlord","overlord","overlord","overlord","overlord"], 8],
        "exp_4":    [["1","4","5","6","8"], ["overlord","overlord","overlord","overlord","overlord"], 8],
        "exp_5":    [["1","3","4","6","8"], ["overlord","overlord","overlord","overlord","overlord"], 8],
        "exp_6":    [["1","2","4","6","7"], ["overlord","overlord","overlord","overlord","overlord"], 8]
    }
}