{
    "map_name":   "rachmaninoff bound",
    "map_author": "leaf (original)",
    "map_notes":  "",
    "difficulty": 5,
    "map_width":  64,
    "map_height": 20,
    "init_lives": 300,
    "start_pos":  [96,160],
    "tile_dat":   [[0,0,0,0,0,0,0,0,0,0,0,0,0,0,0,0,0,0,0,0,0,0,0,0,0,0,0,0,0,0,0,0,0,0,0,0,0,0,0,0,0,0,0,0,0,0,0,0,0,0,0,0,0,0,0,0,0,0,0,0,0,0,0,0],
                   [0,0,0,0,0,0,0,0,0,0,0,0,0,0,0,0,0,0,0,0,0,0,0,0,0,0,0,0,0,0,0,0,0,0,0,0,0,0,0,0,0,0,0,0,0,0,0,0,0,0,0,0,0,0,0,0,0,0,0,0,0,0,0,0],
                   [0,0,0,0,0,0,0,0,0,0,0,0,0,0,0,0,0,0,0,0,0,0,0,0,0,0,0,0,0,0,0,0,0,0,0,0,0,0,0,0,0,0,0,0,0,0,0,0,0,0,0,0,0,0,0,0,0,0,0,0,0,0,0,0],
                   [0,0,0,1,1,1,1,1,1,1,1,1,1,0,0,0,0,0,0,0,0,0,0,0,0,0,0,0,0,0,0,0,0,0,0,0,0,0,0,0,0,0,0,0,0,0,0,0,0,0,0,0,0,0,0,0,0,0,0,0,0,0,0,0],
                   [0,0,0,1,5,5,5,5,2,2,2,2,1,0,0,0,0,0,0,0,0,0,0,0,0,0,0,0,0,0,0,0,0,0,0,0,0,0,0,0,0,0,0,0,0,0,0,0,0,0,0,0,0,0,0,0,0,0,0,0,0,0,0,0],
                   [0,0,0,1,5,5,5,5,2,2,2,2,1,0,0,0,0,0,0,0,0,0,0,0,0,0,0,0,0,0,0,1,1,1,1,1,1,1,1,1,1,1,0,0,0,0,0,0,0,0,0,0,0,0,0,0,0,0,0,0,0,0,0,0],
                   [0,0,0,1,5,5,5,5,2,2,2,2,1,0,0,0,0,0,0,0,0,0,0,0,0,0,0,0,0,0,0,1,5,5,5,5,2,2,2,2,4,4,0,0,0,0,0,0,0,0,0,0,0,0,0,0,0,0,0,0,0,0,0,0],
                   [0,0,0,1,5,5,5,5,2,2,2,2,1,1,1,1,1,1,1,1,1,1,1,0,0,0,0,0,0,0,0,1,5,5,5,5,2,2,2,2,4,4,0,0,0,0,0,0,0,0,0,0,0,0,0,0,0,0,0,0,0,0,0,0],
                   [0,0,0,1,5,5,5,5,2,2,2,2,4,4,5,5,5,5,2,2,2,2,1,0,0,0,0,0,0,0,0,1,5,5,5,5,2,2,2,2,4,4,0,0,0,0,0,0,0,0,0,0,0,0,0,0,0,0,0,0,0,0,0,0],
                   [0,0,0,1,5,5,5,5,2,2,2,2,4,4,5,5,5,5,2,2,2,2,1,0,0,0,0,0,0,1,1,1,5,5,5,5,2,2,2,2,4,4,0,0,0,0,0,0,0,0,0,0,0,0,0,0,0,0,0,0,0,0,0,0],
                   [0,0,0,1,5,5,5,5,2,2,2,2,4,4,5,5,5,5,2,2,2,2,1,0,0,0,0,0,0,1,2,2,2,2,1,1,1,1,1,1,1,1,0,0,0,0,0,0,0,0,0,0,0,0,0,0,0,0,0,0,0,0,0,0],
                   [0,0,0,1,5,5,5,5,2,2,2,2,4,4,5,5,5,5,2,2,2,2,1,1,1,1,1,1,1,1,2,2,2,2,1,0,0,0,0,0,0,0,0,0,0,0,0,0,0,0,0,0,0,0,0,0,0,0,0,0,0,0,0,0],
                   [0,0,0,1,5,5,5,5,2,2,2,2,1,1,1,1,1,1,5,5,5,5,2,2,2,2,5,5,5,5,2,2,2,2,1,0,0,0,0,0,0,0,0,0,0,0,0,0,0,0,0,0,0,0,0,0,0,0,0,0,0,0,0,0],
                   [0,0,0,1,5,5,5,5,2,2,2,2,1,0,0,0,0,1,5,5,5,5,2,2,2,2,5,5,5,5,2,2,2,2,1,0,0,0,0,0,0,0,0,0,0,0,0,0,0,0,0,0,0,0,0,0,0,0,0,0,0,0,0,0],
                   [0,0,0,1,5,5,5,5,2,2,2,2,1,0,0,0,0,1,5,5,5,5,2,2,2,2,5,5,5,5,1,1,1,1,1,0,0,0,0,0,0,0,0,0,0,0,0,0,0,0,0,0,0,0,0,0,0,0,0,0,0,0,0,0],
                   [0,0,0,1,5,5,5,5,2,2,2,2,1,0,0,0,0,1,5,5,5,5,2,2,2,2,5,5,5,5,1,0,0,0,0,0,0,0,0,0,0,0,0,0,0,0,0,0,0,0,0,0,0,0,0,0,0,0,0,0,0,0,0,0],
                   [0,0,0,1,1,1,1,1,1,1,1,1,1,0,0,0,0,1,1,1,1,1,1,1,1,1,1,1,1,1,1,0,0,0,0,0,0,0,0,0,0,0,0,0,0,0,0,0,0,0,0,0,0,0,0,0,0,0,0,0,0,0,0,0],
                   [0,0,0,0,0,0,0,0,0,0,0,0,0,0,0,0,0,0,0,0,0,0,0,0,0,0,0,0,0,0,0,0,0,0,0,0,0,0,0,0,0,0,0,0,0,0,0,0,0,0,0,0,0,0,0,0,0,0,0,0,0,0,0,0],
                   [0,0,0,0,0,0,0,0,0,0,0,0,0,0,0,0,0,0,0,0,0,0,0,0,0,0,0,0,0,0,0,0,0,0,0,0,0,0,0,0,0,0,0,0,0,0,0,0,0,0,0,0,0,0,0,0,0,0,0,0,0,0,0,0],
                   [0,0,0,0,0,0,0,0,0,0,0,0,0,0,0,0,0,0,0,0,0,0,0,0,0,0,0,0,0,0,0,0,0,0,0,0,0,0,0,0,0,0,0,0,0,0,0,0,0,0,0,0,0,0,0,0,0,0,0,0,0,0,0,0]],
    "obstacle_1": {
        "startbox": [128,64,192,256],
        "endbox":   [672,64,736,256],
        "revive":   [160,160],
        "actions":  [["move_player", 0], ["add_lives", 0], ["change_music", ""]],
        "loc_1":    [224,128,288,192],
        "loc_2":    [288,128,352,192],
        "loc_3":    [288,192,352,256],
        "loc_4":    [352,192,416,256],
        "loc_5":    [416,192,480,256],
        "loc_6":    [480,160,544,224],
        "loc_7":    [512,96,576,160],
        "loc_8":    [576,96,640,160],
        "exp_1":    [["2","3","5","7","8"], ["overlord","overlord","overlord","overlord","overlord"], 7],
        "exp_2":    [["2","3","5","6","8"], ["overlord","overlord","overlord","overlord","overlord"], 7],
        "exp_3":    [["1","3","4","6","8"], ["overlord","overlord","overlord","overlord","overlord"], 7],
        "exp_4":    [["1","3","4","6","8"], ["overlord","overlord","overlord","overlord","overlord"], 7],
        "exp_5":    [["1","2","4","6","7"], ["overlord","overlord","overlord","overlord","overlord"], 7],
        "exp_6":    [["1","2","4","5","7"], ["overlord","overlord","overlord","overlord","overlord"], 7]
    }
}