{
    "map_name":   "test map 0",
    "map_author": "mauz",
    "map_notes":  "this is a test, no more no less.",
    "difficulty": 2,
    "map_width":  32,
    "map_height": 16,
    "starting_lives": 5,
    "player_starts":  [[80,96]],
    "tile_dat": [[3,3,3,3,3,3,3,3,3,3,3,3,3,3,3,3,3,3,3,3,3,3,3,3,3,3,3,3,3,3,3,3],
                 [3,3,3,3,3,3,3,3,3,3,3,3,3,3,3,3,3,3,3,3,3,3,3,3,3,3,3,3,3,3,3,3],
                 [3,3,3,3,3,3,3,3,3,3,3,3,2,2,2,2,3,3,3,3,3,3,3,3,3,3,3,3,3,3,3,3],
                 [3,3,3,3,3,3,3,3,3,3,3,3,2,2,2,2,3,3,3,3,3,3,3,3,3,3,3,3,3,3,3,3],
                 [3,3,3,3,4,4,4,4,2,2,2,2,2,2,2,2,2,2,2,2,4,4,4,4,3,3,3,3,3,3,3,3],
                 [3,3,3,3,4,4,4,4,2,2,2,2,2,2,2,2,2,2,2,2,4,4,4,4,3,3,3,3,3,3,3,3],
                 [3,3,3,3,4,4,4,4,2,2,2,2,2,2,2,2,2,2,2,2,4,4,4,4,3,3,3,3,3,3,3,3],
                 [3,3,3,3,4,4,4,4,2,2,2,2,2,2,2,2,2,2,2,2,4,4,4,4,3,3,3,3,3,3,3,3],
                 [3,3,3,3,3,3,3,3,3,3,3,3,2,2,2,2,3,3,3,3,3,3,3,3,3,3,3,3,3,3,3,3],
                 [3,3,3,3,3,3,3,3,3,3,3,3,2,2,2,2,3,3,3,3,3,3,3,3,3,3,3,3,3,3,3,3],
                 [3,3,3,3,3,3,3,3,3,3,3,3,2,2,2,2,3,3,3,3,3,3,3,3,3,3,3,3,3,3,3,3],
                 [3,3,3,3,3,3,3,3,3,3,3,3,2,2,2,2,3,3,3,3,3,3,3,3,3,3,3,3,3,3,3,3],
                 [3,3,3,3,3,3,3,3,3,3,3,3,3,3,3,3,3,3,3,3,3,3,3,3,3,3,3,3,3,3,3,3],
                 [3,3,3,3,3,3,3,3,3,3,3,3,3,3,3,3,3,3,3,3,3,3,3,3,3,3,3,3,3,3,3,3],
                 [3,3,3,3,3,3,3,3,3,3,3,3,3,3,3,3,3,3,3,3,3,3,3,3,3,3,3,3,3,3,3,3],
                 [3,3,3,3,3,3,3,3,3,3,3,3,3,3,3,3,3,3,3,3,3,3,3,3,3,3,3,3,3,3,3,3]],
    "obstacle_1": {
        "startbox": [96, 64, 128, 128],
        "endbox":   [352, 64, 384, 128],
        "revive":   [96, 96],
        "loc_1-1":  [128, 64, 192, 128, "overlord", "overlord"],
        "loc_1-2":  [192, 64, 256, 128, "overlord", "overlord"],
        "loc_1-3":  [256, 64, 320, 128, "overlord", "overlord"],
        "loc_1-4":  [192, 128, 256, 192, "overlord", "overlord"],
        "event_0":  ["explode_locs", ["1-1", "1-2", "1-3"], 13],
        "event_1":  ["explode_locs", ["1-2", "1-4"], 13]
    }
}